{
    "22": 0,
    "26": 1,
    "36": 2,
    "37": 3,
    "38": 4,
    "40": 5,
    "42": 6,
    "44": 7,
    "45": 8,
    "46": 9,
    "48": 10,
    "51": 11,
    "53": 12,
    "55": 13,
    "_": 14
}